BN=1,FLR=4
. . / . . g
. . / . . .
. . / . . .
. . / . . .
. . / . . .
a . / . . .